  8 7
00111111
00122221
11133321
15234421
12344411
11112210
00011110